**********
* p      *
*        *
*        *
*        *
*     m  *
*        *
*        *
*        *
**********